abbr,-3,-2,-1,base,+1,+2,+3
1T,-30,-20,-10,40,20,40,60
1S,-30,-20,-10,40,20,40,60
1Lo,-30,-20,-10,50,20,40,60
1F,-30,-20,-10,50,20,40,60
1Lz,-30,-20,-10,60,20,40,60
1A,-60,-40,-20,110,20,40,60
2T,-60,-40,-20,130,20,40,60
2S,-60,-40,-20,130,20,40,60
2Lo,-90,-60,-30,180,30,60,90
2F,-90,-60,-30,190,30,60,90
2Lz,-90,-60,-30,210,30,60,90
2A,-150,-100,-50,330,50,100,150
3T,-210,-140,-70,430,70,140,210
3S,-210,-140,-70,440,70,140,210
3Lo,-210,-140,-70,510,70,140,210
3F,-210,-140,-70,530,70,140,210
3Lz,-210,-140,-70,600,70,140,210
3A,-300,-200,-100,850,100,200,300
4T,-400,-240,-120,1030,100,200,300
4S,-400,-240,-120,1050,100,200,300
4Lo,-400,-240,-120,1200,100,200,300
4F,-400,-240,-120,1230,100,200,300
4Lz,-400,-240,-120,1360,100,200,300
4A,-400,-240,-120,1500,120,240,360
1T<,-30,-20,-10,30,20,40,60
1S<,-30,-20,-10,30,20,40,60
1Lo<,-30,-20,-10,40,20,40,60
1F<,-30,-20,-10,40,20,40,60
1Lz<,-30,-20,-10,50,20,40,60
1A<,-60,-40,-20,80,20,40,60
2T<,-60,-40,-20,90,20,40,60
2S<,-60,-40,-20,90,20,40,60
2Lo<,-90,-60,-30,130,30,60,90
2F<,-90,-60,-30,140,30,60,90
2Lz<,-90,-60,-30,150,30,60,90
2A<,-150,-100,-50,230,50,100,150
3T<,-210,-140,-70,300,70,140,210
3S<,-210,-140,-70,310,70,140,210
3Lo<,-210,-140,-70,360,70,140,210
3F<,-210,-140,-70,370,70,140,210
3Lz<,-210,-140,-70,420,70,140,210
3A<,-300,-200,-100,590,100,200,300
4T<,-400,-240,-120,800,100,200,300
4S<,-400,-240,-120,810,100,200,300
4Lo<,-400,-240,-120,840,100,200,300
4F<,-400,-240,-120,860,100,200,300
4Lz<,-400,-240,-120,950,100,200,300
4A<,-400,-240,-120,1050,120,240,360
1T<<,0,0,0,0,0,0,0
1S<<,0,0,0,0,0,0,0
1Lo<<,0,0,0,0,0,0,0
1F<<,0,0,0,0,0,0,0
1Lz<<,0,0,0,0,0,0,0
1A<<,0,0,0,0,0,0,0
2T<<,-30,-20,-10,40,20,40,60
2S<<,-30,-20,-10,40,20,40,60
2Lo<<,-30,-20,-10,50,20,40,60
2F<<,-30,-20,-10,50,20,40,60
2Lz<<,-30,-20,-10,60,20,40,60
2A<<,-60,-40,-20,110,20,40,60
3T<<,-60,-40,-20,130,20,40,60
3S<<,-60,-40,-20,130,20,40,60
3Lo<<,-90,-60,-30,180,30,60,90
3F<<,-90,-60,-30,190,30,60,90
3Lz<<,-90,-60,-30,210,30,60,90
3A<<,-150,-100,-50,330,50,100,150
4T<<,-210,-140,-70,430,70,140,210
4S<<,-210,-140,-70,440,70,140,210
4Lo<<,-210,-140,-70,510,70,140,210
4F<<,-210,-140,-70,530,70,140,210
4Lz<<,-210,-140,-70,600,70,140,210
4A<<,-300,-200,-100,850,100,200,300
1Fe,-30,-20,-10,40,20,40,60
1Lze,-30,-20,-10,50,20,40,60
2Fe,-90,-60,-30,140,30,60,90
2Lze,-90,-60,-30,150,30,60,90
3Fe,-210,-140,-70,370,70,140,210
3Lze,-210,-140,-70,420,70,140,210
4Fe,-400,-240,-120,860,100,200,300
4Lze,-400,-240,-120,950,100,200,300
1Fe<,-30,-20,-10,30,20,40,60
1Lze<,-30,-20,-10,40,20,40,60
2Fe<,-90,-60,-30,130,30,60,90
2Lze<,-90,-60,-30,140,30,60,90
3Fe<,-210,-140,-70,320,70,140,210
3Lze<,-210,-140,-70,360,70,140,210
4Fe<,-400,-240,-120,800,100,200,300
4Lze<,-400,-240,-120,840,100,200,300
1Fe<<,0,0,0,0,0,0,0
1Lze<<,0,0,0,0,0,0,0
2Fe<<,-30,-20,-10,40,20,40,60
2Lze<<,-30,-20,-10,50,20,40,60
3Fe<<,-90,-60,-30,140,30,60,90
3Lze<<,-90,-60,-30,150,30,60,90
4Fe<<,-210,-140,-70,370,70,140,210
4Lze<<,-210,-140,-70,420,70,140,210
USpB,-90,-60,-30,100,50,100,150
USp1,-90,-60,-30,120,50,100,150
USp2,-90,-60,-30,150,50,100,150
USp3,-90,-60,-30,190,50,100,150
USp4,-90,-60,-30,240,50,100,150
SSpB,-90,-60,-30,110,50,100,150
SSp1,-90,-60,-30,130,50,100,150
SSp2,-90,-60,-30,160,50,100,150
SSp3,-90,-60,-30,210,50,100,150
SSp4,-90,-60,-30,250,50,100,150
CSpB,-90,-60,-30,110,50,100,150
CSp1,-90,-60,-30,140,50,100,150
CSp2,-90,-60,-30,180,50,100,150
CSp3,-90,-60,-30,230,50,100,150
CSp4,-90,-60,-30,260,50,100,150
LSpB,-90,-60,-30,120,50,100,150
LSp1,-90,-60,-30,150,50,100,150
LSp2,-90,-60,-30,190,50,100,150
LSp3,-90,-60,-30,240,50,100,150
LSp4,-90,-60,-30,270,50,100,150
FUSpB,-90,-60,-30,150,50,100,150
FUSp1,-90,-60,-30,170,50,100,150
FUSp2,-90,-60,-30,200,50,100,150
FUSp3,-90,-60,-30,240,50,100,150
FUSp4,-90,-60,-30,290,50,100,150
FUSpBV,-90,-60,-30,110,50,100,150
FUSp1V,-90,-60,-30,120,50,100,150
FUSp2V,-90,-60,-30,140,50,100,150
FUSp3V,-90,-60,-30,170,50,100,150
FUSp4V,-90,-60,-30,200,50,100,150
FSSpB,-90,-60,-30,170,50,100,150
FSSp1,-90,-60,-30,200,50,100,150
FSSp2,-90,-60,-30,230,50,100,150
FSSp3,-90,-60,-30,260,50,100,150
FSSp4,-90,-60,-30,300,50,100,150
FSSpBV,-90,-60,-30,120,50,100,150
FSSp1V,-90,-60,-30,140,50,100,150
FSSp2V,-90,-60,-30,160,50,100,150
FSSp3V,-90,-60,-30,180,50,100,150
FSSp4V,-90,-60,-30,210,50,100,150
FCSpB,-90,-60,-30,160,50,100,150
FCSp1,-90,-60,-30,190,50,100,150
FCSp2,-90,-60,-30,230,50,100,150
FCSp3,-90,-60,-30,280,50,100,150
FCSp4,-90,-60,-30,320,50,100,150
FCSpBV,-90,-60,-30,110,50,100,150
FCSp1V,-90,-60,-30,130,50,100,150
FCSp2V,-90,-60,-30,160,50,100,150
FCSp3V,-90,-60,-30,200,50,100,150
FCSp4V,-90,-60,-30,220,50,100,150
FLSpB,-90,-60,-30,170,50,100,150
FLSp1,-90,-60,-30,200,50,100,150
FLSp2,-90,-60,-30,240,50,100,150
FLSp3,-90,-60,-30,290,50,100,150
FLSp4,-90,-60,-30,320,50,100,150
FLSpBV,-90,-60,-30,120,50,100,150
FLSp1V,-90,-60,-30,140,50,100,150
FLSp2V,-90,-60,-30,170,50,100,150
FLSp3V,-90,-60,-30,200,50,100,150
FLSp4V,-90,-60,-30,220,50,100,150
CUSpB,-90,-60,-30,150,50,100,150
CUSp1,-90,-60,-30,170,50,100,150
CUSp2,-90,-60,-30,200,50,100,150
CUSp3,-90,-60,-30,240,50,100,150
CUSp4,-90,-60,-30,290,50,100,150
CSSpB,-90,-60,-30,160,50,100,150
CSSp1,-90,-60,-30,190,50,100,150
CSSp2,-90,-60,-30,230,50,100,150
CSSp3,-90,-60,-30,260,50,100,150
CSSp4,-90,-60,-30,300,50,100,150
CCSpB,-90,-60,-30,170,50,100,150
CCSp1,-90,-60,-30,200,50,100,150
CCSp2,-90,-60,-30,230,50,100,150
CCSp3,-90,-60,-30,280,50,100,150
CCSp4,-90,-60,-30,320,50,100,150
CLSpB,-90,-60,-30,170,50,100,150
CLSp1,-90,-60,-30,200,50,100,150
CLSp2,-90,-60,-30,240,50,100,150
CLSp3,-90,-60,-30,290,50,100,150
CLSp4,-90,-60,-30,320,50,100,150
FCUSpB,-90,-60,-30,150,50,100,150
FCUSp1,-90,-60,-30,170,50,100,150
FCUSp2,-90,-60,-30,200,50,100,150
FCUSp3,-90,-60,-30,240,50,100,150
FCUSp4,-90,-60,-30,290,50,100,150
FCSSpB,-90,-60,-30,160,50,100,150
FCSSp1,-90,-60,-30,190,50,100,150
FCSSp2,-90,-60,-30,230,50,100,150
FCSSp3,-90,-60,-30,260,50,100,150
FCSSp4,-90,-60,-30,300,50,100,150
FCCSpB,-90,-60,-30,170,50,100,150
FCCSp1,-90,-60,-30,200,50,100,150
FCCSp2,-90,-60,-30,230,50,100,150
FCCSp3,-90,-60,-30,280,50,100,150
FCCSp4,-90,-60,-30,320,50,100,150
FCLSpB,-90,-60,-30,170,50,100,150
FCLSp1,-90,-60,-30,200,50,100,150
FCLSp2,-90,-60,-30,240,50,100,150
FCLSp3,-90,-60,-30,290,50,100,150
FCLSp4,-90,-60,-30,320,50,100,150
CoSpB,-90,-60,-30,150,50,100,150
CoSp1,-90,-60,-30,170,50,100,150
CoSp2,-90,-60,-30,200,50,100,150
CoSp3,-90,-60,-30,250,50,100,150
CoSp4,-90,-60,-30,300,50,100,150
CoSpBV,-90,-60,-30,110,50,100,150
CoSp1V,-90,-60,-30,130,50,100,150
CoSp2V,-90,-60,-30,150,50,100,150
CoSp3V,-90,-60,-30,180,50,100,150
CoSp4V,-90,-60,-30,210,50,100,150
FCoSpB,-90,-60,-30,150,50,100,150
FCoSp1,-90,-60,-30,170,50,100,150
FCoSp2,-90,-60,-30,200,50,100,150
FCoSp3,-90,-60,-30,250,50,100,150
FCoSp4,-90,-60,-30,300,50,100,150
FCoSpBV,-90,-60,-30,110,50,100,150
FCoSp1V,-90,-60,-30,130,50,100,150
FCoSp2V,-90,-60,-30,150,50,100,150
FCoSp3V,-90,-60,-30,180,50,100,150
FCoSp4V,-90,-60,-30,210,50,100,150
CCoSpB,-90,-60,-30,170,50,100,150
CCoSp1,-90,-60,-30,200,50,100,150
CCoSp2,-90,-60,-30,250,50,100,150
CCoSp3,-90,-60,-30,300,50,100,150
CCoSp4,-90,-60,-30,350,50,100,150
CCoSpBV,-90,-60,-30,150,50,100,150
CCoSp1V,-90,-60,-30,170,50,100,150
CCoSp2V,-90,-60,-30,200,50,100,150
CCoSp3V,-90,-60,-30,250,50,100,150
CCoSp4V,-90,-60,-30,300,50,100,150
FCCoSpB,-90,-60,-30,170,50,100,150
FCCoSp1,-90,-60,-30,200,50,100,150
FCCoSp2,-90,-60,-30,250,50,100,150
FCCoSp3,-90,-60,-30,300,50,100,150
FCCoSp4,-90,-60,-30,350,50,100,150
FCCoSpBV,-90,-60,-30,150,50,100,150
FCCoSp1V,-90,-60,-30,170,50,100,150
FCCoSp2V,-90,-60,-30,200,50,100,150
FCCoSp3V,-90,-60,-30,250,50,100,150
FCCoSp4V,-90,-60,-30,300,50,100,150
StSqB,-90,-60,-30,150,50,100,150
StSq1,-90,-60,-30,180,50,100,150
StSq2,-150,-100,-50,260,50,100,150
StSq3,-210,-140,-70,330,50,100,150
StSq4,-210,-140,-70,390,70,140,210
ChSq1,-150,-100,-50,200,70,140,210
